- 182 ·-

Keteir - Ketlrin (loeus).

Kleteve - Glottevia (regie Warmi-
ensis, nune villa Glottau).

Kladina Kladne -Calde (lacus).

Labrir'r - Labun [lucus secer apud
Regiomentem).

Laeeniee - Lasnitz (rivus).

Leutany - laueks (ager).

Louny = Lriny - lun (age1·); Lunave,
Lunau (villae).

Libve - Lywa (fluvius ad Marien·
werder).

Lipina — Lippin (viiia).

Liske - Lisske (insula apud Terunem).

Maleiov — Malseue, Molsehoven (lacus
et villae nemen).

Makra - Mokera (fluvius Pomeraniae).

Neleehov —- Naligau (loeus).

Palusin — Palatia (villa).

Petinke - Passin (ville).

Pisniee — Pissa (fluviolus).

Ples -— Plesin (villa).

Polaky - polea (ager).

Pomneniee — Pemenen (loeus).

Postoviee — posta (compascuus ager).

Piehoi - Pregora (antiqua dene-
minatio fluminis nune Pregel dieti).

Bebetin - Babaezin (loeus Ermelan-
diae).

Bole-luky - Bole-lankin (campus).

Boeyne — Bosin (silva).

Draby - dravis (apiarius).

Drusnov — Drusnie (stagnum, Drau-
sen-See).

Hiber, Hrboviee - garbe, gerwis
(vreh3 ef. pa·hrb).

Hieben - Grebyn (castrum).

Hiiby, Hiibsko — Grebow (loeus).

Jilemnt - Ylmune (fluvius).

Jindiee (Indice) -— Indisse (lacus).

Kampe <insula Pragae) — Kampe,
*kampe (insula), Kampenau (villa).

Katov - Katthow (territorium).

Piovlky - Passeluk (regie apud
civitatem Holandiam). ’

Fusio-very - Peste-waitis. ἱ

Ruina, Rudniee - Ruddin (villa),
Rudanz (regio).

Rodna - Rodenow (villa).

Rohev - Rogew (rivulus et villa,
oestrum apud Torunam).

Rehezee — Begoes, Rogosen (villae
Ermelandiae et Pomeraniae).

Romeva - Remove (campus saeer
eum lueo).

Rouna — Rina (rivulus apud Bruns·
bergiam).

Sonent — Sudithen (ager).

Stetiee — stogis (tectum).

Stradouir - Stradaunen (villa). ,

strebin - Strebe (fluvius).

Teiin - Tessen (lacus).

Truseniee, Trurnow — Truse (vetus
villacommercialisinAntiquaPruseia.)

Tupadly - 'Pupedel (vicus in Po·
merellie).'

Veliehov — Beliehow (castrum).

Vlkoniee — Wilkenit (villa).

vyrkov — Wiseovia (castrum).

Krty - Kertene (silva). .

Krsov, Krsoviee — Kirsovie (terri- .
terium Sudaviae).

Kolovet — Oolowaeh (loeus Samlan·
diae).

Lipa — Lypa (castrum ad Rehden).

Mentire - mentiris (quiri).

Meruniee - Merune (nem. viri),
Mahrunen (loeus).

. ¹Nadryby - Nadrawe (nom. viri),

Nadrau (loeus), Nadrovia (regie).
Ozke · brhy = wose · birge, (loeus =
Ziegenlager‚ ozka z ziege).

Ι Peliny - Pelle (nom. viri), Pellin,

Pelyn (loeus).
Soumei — Summir (laeua)
Vlkov — Wilkow ·(loeus).

 

